                                                            
                                                            
                                 ,                           
                       .. ..🦆.                              
                       .  .P. ......                        
                        ...         ...            nyaaa         
                        .  .          .                     
                        .             .                     
                         .        .                         
                         ..   ..     .                      
                          ..       ..                       
                            ..    .                         
                              ....                      
                               .              ..            
                              ..                            
               ...            ....         ..               
                  . . .     ...  ...   ..                   
                        .....      ....                     
                        ...          ...                    
                       ..               ..    ...              
                     ..                   ..                
                   ...                       .              
                 ...                          . .           
                ..                         .......          
               .... ................ . ....                 
                         .              .                   
                        .                .                  
                        .                .                  
                        .                ..                 
                        .                 .                 